# START X Y
#----------
1 1
#----------
# SINK CYCLE DURATION
# jak dlouho trva jedna faze potapeni, cim mensi tim rychlejs se plosinky potapjeji
#--------------------
500
#--------------------
# PLATFORM MAP
# SWAMP = 0  ISLE = 1  DINO = 2  MOVER_AREA = 3
#------------------
0 0 0 0 0 0 0 0 0 0
1 1 1 2 1 1 2 1 1 1
0 0 1 0 0 0 0 1 0 0
0 0 1 1 2 1 2 1 0 0
0 0 0 0 1 0 1 0 0 0
0 0 0 0 1 0 1 0 0 0
0 0 0 0 1 2 1 0 0 0
0 1 1 1 1 2 2 0 0 0
0 0 0 0 0 2 1 1 1 1
0 0 0 0 0 0 0 0 0 0
#------------------
# SINK MAP
# cislo = za jak dlouho po startu levelu se plosinka zacne potapet
#---------------------------------------
   0   0   0   0   0   0   0   0   0   0
   4  15  15   7  15  15   8  15  15   4
   0   0  17   0   0   0   0  17   0   0
   0   0  19  19  19  19  19  19   0   0
   0   0   0   0  21   0  21   0   0   0
   0   0   0   0  23   0  23   0   0   0
   0   0   0   0  25  14  25   0   0   0
   0   4  27  27  27  27  12   0   0   0
   0   0   0   0   0  29  29  29  30   4
   0   0   0   0   0   0   0   0   0   0
#---------------------------------------
# ENTITY MAP
# 0 = NIC  1 = ENEMY  2 = ITEM  3 = END
#------------------
0 0 0 0 0 0 0 0 0 0
0 0 0 0 0 0 0 0 2 0 
0 0 0 0 0 0 0 0 0 0  
0 0 0 0 0 0 0 0 0 0  
0 0 0 0 0 0 0 0 0 0  
0 0 0 0 0 0 0 0 0 0  
0 0 0 0 0 0 0 0 0 0  
0 0 0 0 0 0 0 0 0 0  
0 0 0 0 0 0 0 1 3 0  
0 0 0 0 0 0 0 0 0 0
#------------------
# MOVER ID MAP
# cislo = index moveru kterej se pohybuje v oblasti mover area vyhrazeny na mape plosinek
#------------------
0 0 0 0 0 0 0 0 0 0
0 0 0 0 0 0 0 0 0 0
0 0 0 0 0 0 0 0 0 0
0 0 0 0 0 0 0 0 0 0
0 0 0 0 0 0 0 0 0 0
0 0 0 0 0 0 0 0 0 0
0 0 0 0 0 0 0 0 0 0
0 0 0 0 0 0 0 0 0 0
0 0 0 0 0 0 0 0 0 0
0 0 0 0 0 0 0 0 0 0
#------------------
# MOVERS
# prvni radek je pocet moveru (muze byt nula)
# pro kazdy mover nasleduje jeden radek ve tvaru
# Y X1 X2 WAIT_TIME SLOWNESS
#------------------
0
#------------------