# START X Y
#----------
4 5
#----------
# SINK CYCLE DURATION
# jak dlouho trva jedna faze potapeni, cim mensi tim rychlejs se plosinky potapjeji
#--------------------
500
#--------------------
# PLATFORM MAP
# SWAMP = 0  ISLE = 1  DINO = 2  MOVER_AREA = 3
#------------------
0 1 0 0 0 0 0 0 0 0
1 1 3 3 3 3 1 1 1 1
1 0 0 0 0 0 0 0 0 0
1 0 1 1 1 1 1 1 1 0
1 0 1 0 0 0 0 0 1 0
1 0 1 0 1 1 1 0 1 0
1 0 1 0 0 0 1 0 1 0
1 0 1 1 1 1 1 0 1 0
1 0 0 0 0 0 0 0 1 1
1 1 3 3 3 3 3 3 1 0
#------------------
# SINK MAP
# cislo = za jak dlouho po startu levelu se plosinka zacne potapet
#---------------------------------------
   0  46   0   0   0   0   0   0   0   0
  44  45   0   0   0   0  47  48  49  50
  43   0   0   0   0   0   0   0   0   0
  42   0  20  21  22  23  24  25  26   0
  41   0  19   0   0   0   0   0  27   0
  40   0  18   0   8   9  10   0  28   0
  39   0  17   0   0   0  11   0  29   0
  38   0  16  15  14  13  12   0  30   0
  37   0   0   0   0   0   0   0  31  32
  36  35   0   0   0   0   0   0  33   0
#---------------------------------------
# ENTITY MAP
# 0 = NIC  1 = ENEMY  2 = ITEM  3 = END
#------------------
0 2 0 0 0 0 0 0 0 0
0 0 0 0 0 0 0 1 0 3 
0 0 0 0 0 0 0 0 0 0  
0 0 0 0 0 0 0 0 0 0  
0 0 0 0 0 0 0 0 0 0  
0 0 0 0 0 0 0 0 0 0  
0 0 0 0 0 0 0 0 0 0  
0 0 0 0 0 0 0 0 0 0  
0 0 0 0 0 0 0 0 0 2  
1 0 0 0 0 0 0 0 0 0
#------------------
# MOVER ID MAP
# cislo = index moveru kterej se pohybuje v oblasti mover area vyhrazeny na mape plosinek
#------------------
0 0 0 0 0 0 0 0 0 0
0 0 2 2 2 2 0 0 0 0
0 0 0 0 0 0 0 0 0 0
0 0 0 0 0 0 0 0 0 0
0 0 0 0 0 0 0 0 0 0
0 0 0 0 0 0 0 0 0 0
0 0 0 0 0 0 0 0 0 0
0 0 0 0 0 0 0 0 0 0
0 0 0 0 0 0 0 0 0 0
0 0 1 1 1 1 1 1 0 0
#------------------
# MOVERS
# prvni radek je pocet moveru (muze byt nula)
# pro kazdy mover nasleduje jeden radek ve tvaru
# Y X1 X2 WAIT_TIME SLOWNESS
#------------------
2
9 7 2 800 500
1 5 2 800 500
#------------------